--- East Asian
Bopo : Bopomofo
- Dai
Hanb Hani Hans Hant : Han
Hang : Hangul
Hira : Hiragana
Kana : Katakana
Lana : Tai
Kitl Kits: Khitan
Nkdb Nkgb : Naxi
- Nuchen
Plrd : Pollard
- Tungut
- Jiagu
- Yao
- Yunnan
--- South East Asian
Batk : Batak
Beng : Bengali
Bugi : Buginese
Mymr : Burmese
Cham : Cham
Java : Javanese
Khmr : Khmer
Laoo : Lao
Lisu : Lisu
Mtei : Meitei
Thai : Thai
Yiii : Yi
Bali : Balinese
Khar : Kharoshthi
- Pyu
Rjng : Rejang
Roro : Rongorongo
Tglg : Tagalog
Wole : Woleai
Buhd : Buhid
- Kavi
- Lampong
- Mangyan
- Pali
Tagb : Tagbanwa
